##############
##      # #  #
# S# ##     ##
# ##  # # #  #
#  # ## # # ##
# ####### #  #
#       #### #
# # #####    #
###     ### ##
# # ###   ####
#     # #    #
## ###### ## #
#E      #  # #
##############

